#####################   #####################   #####################
#.......PORTA.......#   #.......PORTA.......#   #.......PORTA.......#
#...................#   #...................#   #...................#
#...................#   #...................#   #...................#
#.........##........#   #......########.....#   #.......#######.....#
#.......####........#   #....##.......##....#   #.....##......##....#
#......#####........#   #...##.........##...#   #....##........##...#
#.....##..##........#   #..............##...#   #...##.........##...#
#....##...##........#   #..............##...#   #.............###...#
#.........##........#   #..............##...#   #............###....#
#.........##........#   #.............##....#   #..........###......#
#.........##........#   #...........##......#   #.......####........#
#.........##........#   #.........##........#   #..........###......#
#.........##........#   #.......##..........#   #............###....#
#.........##........#   #.....##............#   #.............###...#
#.........##........#   #...##..............#   #...##.........##...#
#.........##........#   #...##..............#   #....##........##...#
#....###########....#   #...##..............#   #.....##......##....#
#...#############...#   #...#############...#   #.......#######.....#
#...................#   #...................#   #...................#
#...................#   #...................#   #...................#
#...................#   #...................#   #...................#
#####################   #####################   #####################